deepin-font-manager	non-font/tool
fluidsynth	        non-font/tool
font-manager	        non-font/tool
font-v	                non-font/tool
gnome-font-viewer	non-font/tool
opendesktop-fonts	asian
otf-aurulent-nerd	non-font/tool
otf-codenewroman-nerd	non-font/tool
otf-comicshanns-nerd	non-font/tool
otf-commit-mono-nerd	non-font/tool
otf-droid-nerd	        non-font/tool
otf-firamono-nerd	non-font/tool
otf-font-awesome	non-font/tool
otf-geist-mono-nerd	non-font/tool
otf-hasklig-nerd	non-font/tool
otf-hermit-nerd	        non-font/tool
otf-monaspace-nerd	non-font/tool
otf-monaspace-nerdfonts	non-font/tool
otf-opendyslexic-nerd	non-font/tool
otf-overpass-nerd	non-font/tool
perl-font-afm	        non-font/tool
perl-font-ttf	        non-font/tool
soundfont-fluid	        non-font/tool
texlive-langenglish	non-font/tool
texlive-plaingeneric	non-font/tool
texlive-xetex	        non-font/tool
timidity++	        non-font/tool
ttf-arphic-ukai	        asian
ttf-arphic-uming	asian
ttf-baekmuk     	asian
ttf-hanazono	        asian
ttf-hannom	        asian
ttf-indic-otf	        asian
ttf-jigmo	        asian
ttf-khmer	        asian
ttf-sarasa-gothic	asian
ttf-sazanami	        asian
ttf-scheherazade-new	asian
ttf-tibetan-machine	asian
ttf-vlgothic	        asian
webfont-kit-generator	non-font/tool
woff2-font-awesome	non-font/tool
xorg-font-util	        non-font/tool
xorg-fonts-misc	        non-font/tool

